21 30
1 1 1 1 1 1 1 1 1 1 1 1 1 1 1 1 1 1 1 1 1
1 3 3 3 4 3 3 3 3 3 3 3 3 3 3 4 3 3 3 1 1
1 3 3 3 4 3 3 3 3 3 3 3 3 3 3 4 3 3 3 1 1
1 3 3 3 4 3 3 3 3 3 3 3 3 3 3 4 3 3 3 1 1
1 4 4 4 4 4 4 4 4 4 4 4 4 4 4 4 4 4 4 1 1
1 3 3 3 4 7 8 8 8 8 8 8 8 8 9 4 3 3 3 1 1
1 3 3 3 4 10 11 11 11 11 11 11 11 11 12 4 3 3 3 1 1
1 3 3 3 4 13 14 14 14 14 14 14 14 14 15 4 3 3 3 1 1
1 3 3 3 4 3 3 3 3 3 3 3 3 3 3 4 3 3 3 1 1
1 3 3 3 4 3 3 3 3 3 3 3 3 3 3 4 3 3 3 1 1
1 3 3 3 4 3 3 3 3 3 3 3 3 3 3 4 3 3 3 1 1
1 3 3 3 4 3 3 3 3 3 3 3 3 3 3 4 3 3 3 1 1
1 3 3 3 4 3 3 3 3 3 3 3 3 3 3 4 3 3 3 1 1
1 3 3 3 4 3 3 3 3 3 3 3 3 3 3 4 3 3 3 1 1
1 3 3 3 4 3 3 3 3 3 3 3 3 3 3 4 3 3 3 1 1
1 4 4 4 4 4 4 4 4 4 4 4 4 4 4 4 4 4 4 1 1
1 3 3 3 4 3 3 3 3 3 3 3 3 3 3 4 3 3 3 1 1
1 3 3 3 4 3 3 3 3 3 3 3 3 3 3 4 3 3 3 1 1
1 3 3 3 4 3 3 3 3 3 3 3 3 3 3 4 3 3 3 1 1
1 3 3 1 1 1 1 1 1 1 1 1 1 1 1 1 1 1 1 1 1
1 3 3 1 4 4 4 4 4 4 4 4 4 4 4 4 4 4 4 1 1
1 3 3 1 4 4 4 4 4 4 4 4 4 4 4 4 4 4 4 1 1
1 3 3 1 1 1 1 1 1 1 1 1 1 1 1 1 1 3 3 1 1
1 3 3 1 0 0 0 0 0 0 0 0 0 0 0 0 1 3 3 1 1
1 3 3 1 0 0 0 0 0 0 0 0 0 0 0 0 1 3 3 1 1
1 3 3 1 0 0 0 0 0 0 0 0 0 0 0 0 1 3 3 1 1
1 3 3 1 1 1 1 1 1 1 1 1 1 1 1 1 1 3 3 1 1
1 3 3 3 3 3 3 3 3 3 3 3 3 3 3 3 3 3 3 1 1
1 3 3 3 3 3 3 3 3 3 3 3 3 3 3 3 3 3 3 1 1
1 1 1 1 1 1 1 1 1 1 1 1 1 1 1 1 1 1 1 1 1