20 20
5 1 1 1 1 1 1 1 1 1 1 1 1 1 1 1 1 1 1 6
4 9 9 9 9 9 9 9 9 9 9 9 9 9 9 9 9 9 9 2
4 9 9 9 9 9 9 9 9 9 9 9 9 9 9 9 9 9 9 2
4 9 9 9 9 9 9 9 9 9 9 9 9 9 9 9 9 9 9 2
4 9 9 9 9 9 9 9 9 9 9 9 9 9 9 9 9 9 9 2
4 9 9 9 9 9 9 9 9 9 9 9 9 9 9 9 9 9 9 2
4 9 9 9 9 9 9 9 9 9 9 9 9 9 9 9 9 9 9 2
4 9 9 9 9 9 9 9 9 9 9 9 9 9 9 9 9 9 9 2
4 9 9 9 9 9 9 9 9 9 9 9 9 9 9 9 9 9 9 2
4 9 9 9 9 9 9 9 9 9 9 9 9 9 9 9 9 9 9 2
4 9 9 9 9 9 9 9 9 9 9 9 9 9 9 9 9 9 9 2
4 9 9 9 9 9 9 9 9 9 9 9 9 9 9 9 9 9 9 2
4 9 9 9 9 9 9 9 9 9 9 9 9 9 9 9 9 9 9 2
4 9 9 9 9 9 9 9 9 9 9 9 9 9 9 9 9 9 9 2
4 9 9 9 9 9 9 9 9 9 9 9 9 9 9 9 9 9 9 2
4 9 9 9 9 9 9 9 9 9 9 9 9 9 9 9 9 9 9 2
4 9 9 9 9 9 9 9 9 9 9 9 9 9 9 9 9 9 9 2
4 9 9 9 9 9 9 9 9 9 9 9 9 9 9 9 9 9 9 2
4 9 9 9 9 9 9 9 9 9 9 9 9 9 9 9 9 9 9 2
8 3 3 3 3 3 3 3 3 3 3 3 3 3 3 3 3 3 3 7