20 20
2 2 2 2 2 2 2 2 2 2 2 2 2 2 2 2 2 2 2 2
2 3 3 3 3 3 3 3 3 3 3 3 3 3 3 3 3 3 3 2
2 3 4 4 4 4 4 4 4 4 4 4 4 4 4 4 4 4 3 2
2 3 4 4 4 4 4 4 4 4 4 4 4 4 4 4 4 4 3 2
2 3 4 4 4 4 4 4 4 4 4 4 4 4 4 4 4 4 3 2
2 3 4 4 4 4 4 4 4 4 4 4 4 4 4 4 4 4 3 2
2 3 4 4 4 4 4 4 4 4 4 4 4 4 4 4 4 4 3 2
2 3 5 5 5 5 5 5 5 5 5 5 5 5 5 5 5 5 3 2
2 3 5 5 5 5 5 5 5 5 5 5 5 5 5 5 5 5 3 2
2 3 5 5 5 5 5 5 5 5 5 5 5 5 5 5 5 5 3 2
2 3 5 5 5 5 5 5 5 5 5 5 5 5 5 5 5 5 3 2
2 3 5 5 5 5 5 5 5 5 5 5 5 5 5 5 5 5 3 2
2 3 6 6 6 6 6 6 6 6 6 6 6 6 6 6 6 6 3 2
2 3 6 6 6 6 6 6 6 6 6 6 6 6 6 6 6 6 3 2
2 3 6 6 6 6 6 6 6 6 6 6 6 6 6 6 6 6 3 2
2 3 6 6 6 6 6 6 6 6 6 6 6 6 6 6 6 6 3 2
2 3 7 7 7 7 7 7 7 7 7 7 7 7 7 7 7 7 3 2
2 3 7 7 7 7 7 7 7 7 7 7 7 7 7 7 7 7 3 2
2 3 3 3 3 3 3 3 3 3 3 3 3 3 3 3 3 3 3 2
2 2 2 2 2 2 2 2 2 2 2 2 2 2 2 2 2 2 2 2